NO ./textures/pinkN.png
SO ./textures/blueS.png
WE ./textures/greenW.png
F 192,247,176

EA ./textures/orangeE.png

        1111111111111111111111111
        1000000000110000000000001
        10110000011100000W0000001
        1001000000000000000000001
111111111011000001110000000000001
111111111111111111111111111111111111
