      NO              ./textures/N.png
SO ./textures/S.png
WE           textures/W.png.png
EA ./textures/E.png

F 0, 0, 0x00FFFF
C 225,30,0

1111
10N1
1111