      NO              ./textures/N.png
SO ./textures/S.png
WE           ./textures/W.png
EA ./textures/E.png




F 110,1 ,22
C 110,22,255

1111
1111
    
1111
1W 1
1111
