      NO              ./textures/N.png
SO ./textures/S.png
WE ./textures/W.png
EA ./textures/E.png
F 255,0,0


C 110, 255, 0


1111
1NW1
1111