NO textures/N.png
SO tex/jan.png
WE textures/W.png
EA textures/E.png
F 255,100,0
C 110,30,100


11111
10001
10001
10001
10001
10001
10001
10001
10N01
10001
11111