NO tex/cat.png.png
SO tex/north.png




WE tex/south.png
EA tex/geelmuurtje.png
F 255,100,0
C 110,30,100




        1111111111111111111111111
        1000000000110000000000001
        1011000001110000000000001
        1001000000000000000000001
111111111011000001110000000000001
100000000011000001110111111111111
11110111111111011100000010001
11110111111111011 101010010001
11110111111111011 101010010001
11000000110101011100000010001
10000000000000011000000100001
10000W00000000011010100100001
100000000000000011010100100001
1100000111010101011101111000111
10000111 11101011101111010001
 1111111 1111111 111111111111
10000111 11101011101111010001
 1111111 1111111 111111111111