NO tex/cat.png
SO tex/north.png
WE tex/south.png
EA tex/geelmuurtje.png
F 255,100,0
C 110,30,100

111111
1E101
1111111