NO ./textures/pinkN.png
SO ./textures/blueS.png
WE ./textures/greenW.png
EA ./textures/orangeE.png
F 255,100,0
C 110,30,100

111111
1N101
1111111