NO textures/N.png
SO textures/S.png
WE textures/W.png
EA textures/E.png
F 255,100,0
C 110,30,100

111111
1S101
1111111