NO ./textures/pinkN.png
SO ./textures/blueS.png
WE ./textures/greenW.png
EA ./textures/orangeE.png
F 255,100,0
C 110,30,100

111111111111111111111111111111111111111111111111111111111111111111111111111111111111111111111111111111111
1N001
1111111111111111111111111111111111111111111111111111111111111111111111111111111111111111111111111111111111