NO textures/N.png
SO textures/S.png
WE textures/W.png
EA textures/E.png
F 255,100,0
C 110,30,100

111111111111111111111111111111111111111111111111111111111111111111111111111111111111111111111111111111111
1E001
1111111111111111111111111111111111111111111111111111111111111111111111111111111111111111111111111111111111