NO textures/N.png
SO textures/S.png
WE textures/W.png
EA textures/E.png
F 255,100,0
C 255,100,0

11111111
10000001
10000E01
10000001
11111111
