NO textures/Brick_02-512x512.png
SO textures/Brick_13-512x512.png
WE textures/Brick_15-512x512.png
EA textures/Brick_18-512x512.png
F 255,100,0
C 110,30,100

1111
1N01
1111