NO textures/Brick_02-512x512.png
SO textures/Brick_13-512x512.png
WE textures/Brick_15-512x512.png
EA textures/Brick_18-512x512.png
F 255,100,0
C 110,30,100

11111111
10000001
10000W01
10000001
11111111