NO textures/N.png
SO tex/jan.png
WE textures/W.png
EA textures/E.png
F 255,100,0
C 255,100,0

11111111
10000001
100S0001
10000001
11111111
    